oa	߹H
ol	̃vBa֊܍̐ۑlGܞGCsa}}voKiB@Lcrٌt{GXPqB\aLIJo
oj	󃇅\{H݋Fj^quQVOWICsȀɎsYOtV@B@cg
oh	nnla
ok	°ð酐SWCSRUj`EѠnHxObT΂\֒֓EUGOJ^q
ba	ŰưǰȰɰʰ˰̰ͰΰϰаѰҰӰ԰հɁR^zΊBQyip[ߠWXjqFTj_M҆y^RZTN
bl	װذٰڰ۰ܰݰĆhߒ[Bq]b͓oٔv
bj	߰mЊEʕLDt{OZΌїAknk[C
bh	괈Y͒ʓsgRŐK{Mrߙ^Duo
bk	܃􇥈~pސAޫǘ}˝̙dЈJمEtdshbURdQ_
bq	p˂FhʑvdK{GfͪNDiFuLpiˍR|ؐK݅Tfm^CEcl
bf	ܺ＂ωMٓLy`ǟĪnSGݙGQM
bg	±ñıԁȂȉlRЏgsmԬaegpXEKMJAaGa
bi	ƱǱȱɱʱ˱̱ͱαϱбѱұӱԱձֱױرٱڱ۱ܱذݩ޵Ӂ؂񆞆f`ˋŎƏYPWϔaėa[țaΪnwHRwnzDzKPuv`zaoVXY^bƃ]ɜ͚ΓЋKgvvםP؄CSFP~ۋKLߛtGCq@EN[]sS{{ExImspSzG
bw	ޱ߱KO̐ƒ\OcMנpfKVHeDXŌxҌS׃PHglpqx߄߅QrYbcu@
bz	Ԃlw˙~WdϠgYgàrAEˑFՕրٙlSsMR[jklQTB
bx	e֖°Ta̋rhXM
bc	ރPÚIlpW_Ĝ̞ϙӟhefߓ\ExW
by	Kv숗}ՎTm\mޖ◀VR}Aplus@Muvh@SVm
bo	ذެہN`k\hXŒܖK_qؚݠthiCjBRzq~\J`Ňt`ȕNXoBCJTUqyLm@RK\cn}DGoACFgmpENQP
bu	߲фυąԈmpÒіhir^[ɞaYK^bqJXGL
ca	n
cl	²òĲŲƲǲȲɲʲ˲̂ƆƊu񗏚֠ZnuؔP
cj	ͲβϲвѲҲӲЇAkԋۋKLMӠN|dL]QT֍D{o
e	Բղֲײ}MșP[œni@ىI]
ck	ٲڲ۲ܲܳFٕHHɘG_[Ax
ce	޲߲դȃԅxőyZkuƘYɃ
cf	乍ߗqNd
cg	Ӎ}
ea	ɲÁx∓gKc˗^gpPaőONіӐԈԌۂ\dxl
el	٭򲃊е}OƏϊЃӐO
ej	P]{i}·cωʋȍݎfʑϑԓvC{^ٚIeabvUogCAWpsÈBrM^sПgbcҗS~֝׀׋ۅt{p@aiPKU]
eh	tYLjSǜC`dD^cqOmk_LLMOoKl
ek	遞lzșRq|J}bVeN֚}C}n{
ee	eqÊbؓFݟELusp͒֐܇HފJ
ef	³óEm}גדZ旲M_~QDƐ_kclIrHՀRn֍׏oٕfڒڙ{ܕލp\mYZ
eg	ųƳǳȳɳʳ˳̳ͳγϳгѳҳӾʢة\D\Skw񏻐r~͒ޓΓ՗fr雄ƛ՜˝jAbQVfBwÔ^B|\WXJdpKpldGr
ei	Գճֳ׳سٳڳ۳ܳݳ޳ۭ߳ܯ߳΁́sȄЅhqՅˇiIӐpuJdyLxoIlnnkßUEbvVlaMx}@B]nqÒSKǠNhyDElWԠBvs֖PdmpچFLBދWgt߆MrY|`u[Xc
es	ӿÌבo_H_ҝr\ruxn~ی۠|
eb	ٱŁEGΑo䗹bߠ⮠{NI[IWǓgnԗׇ׉SPcObh~l{O\
eu	ءۻm⃁IbǋЏN}ߗƘZ[sbˬG`lAaeXI^aĕcZexˠ̎{|ՑXa،nUXsIzzrRis
ed	H_
ec	Du
ep	ˁbėٚN[U@xxFiwݎAE
et	дVkyl퓜Hrw}RJ
em	׵鳂DǔNmqD
en	ݻ키b@aÕI~̜_tQËx~NoOɔكwݐcTj
eo	ɇǊŊƋCSFfYbJ}TzuOQ^rYqp
ci	ôĴŴƴǴȴɴʴ˴̴ʹفՁ肽pcܖ曁BuyNrQaWǄFyΈυ~naeڝeio@dqy]
cs	ϴдѴҴӴȅQďSFmBژߝY^|tРQBjbSƉɐ[qZpցz{CEW^
cb	휐ݏ
cu	ִ״شmŊƑ[|qÐIPcKuڂUcnqAy
cp	ڴ۴ߥmx皖䷉UZx{fg
cm	ݴ޴ߴ˥륁yNynժXQW\\yÜăċěP~Jx
cn	Yvߗ
co	vz՗tWsucxP̑PՋHuiSeqz`v
da	A}ҚΚ͞ؠ[}oKJeEQRσuzJއމQ_p`^
dl	ܤ߰셦KΖxyxyHDŕ}yJFې܍ܖDaO^\ln
dj	ʯ쁍d[Sgm·cdn~l[בړۓƖXڠmXDDQNWnEđɅ͞yэRgQ֝yېlG]KFd}r
dh	ɂ}WPɐՓn띋ǞTcGU^XDYřʎo}d[וځTKWh
dk	߶uWΒғvF]͘|cI\R|rRsŏKg@Cmp܄~IZ
de	µõĵ׵ｇNԐzu
dq	
df	O
dg	εŵƵǵȵɵʵ\~O~ŘROQ
di	ĵ̵͵εϵеѵҵӵԵյֵ׵صٵڵ۵ܵݵصڮۡݯݶdCOvhkyDXގRf~KdF㓟Am\bNvbZSYEaedJVlmƇǅǜHLOˋ[EД]hgBpdhyۗBޞfrKd~Cs{LEVWM
dd	
dw	ߵؼڂمÉ|HLюopϘAժeU_Ztd_s͟ۆFc
dz	ݯ􁮊PŏtF@hfHLuyrɉy@qӎ{HcSMJ@m
dx	ܦAUގLg䒔iG۠AByxW]\Ŏ|HHсBeՙg@ېPCl
dy	ƶcŝGOJbYB_ӆbVwr}
dr	GAM
ds	𴂔Pӄĉٍ㒜k|IpL{ǇʐXԘޓ[CH
db	JÄrʆtzԖuXÚћòf]ÖWxKHWkLhLYZ^`a
du	¶öĶŶƶǶȶɶܶ򃙄EXƇ󎪕̙^٪o{VCT}ΖCtGixטKـG`LoA^|b~yt
dp	˶̶Ͷζ϶ǄFeV@faȘуYH
dm	ѶҶӶ׷惵͉[őAw}yqqĄckdBqX
dn	նֶ׶ضٶڶ۶ܶdݏYǓԪ]RPvHOޚqgD
do	ȶҶ޶߶⁏AmʉZbs\ÖٚǞkEƖE]yrFGTo܀IwyDWDyz
oe	Ŷجݭi\vŅن@Hfه׈񊊊ߌSkL~ĚdᜊcuxSXbrdJJʂLYFӞԛM@F׆`؊ܗQވ]e~ypiq\OP~I_Ft{EZ[L|
eh	G
oq	GO
of	ŊCW
og	E
or	٦܁nXprkޚYxsQHn^LԠ@Eڍ[W߃szXDb
fa	늑omVklXPUƞʆtNy
fj	ެFGhiˋ̏鑌iJ~[F\BDOoućwxXϛTӌ؜܏GNCxcxY
fh	·÷ķЂڔPXPEf}KLړ[phJ
fq	ƷǷȷɷʷ˷̷ͷηϷзn|OЎUhՖF{ɗJdOUXCp^QʄʆNnquM]qwy[IWaE
ff	ҷӷԷշַ׷طٷڷ۷ܷݷ޷߷f͆Rbe^}ˏkSBDrJǟWljSiRďȆkʈ_`vӟkrmMpMViBOaXRv
fg	ٺۺtKNO~oQlh͜tmПuԠȪhS`^ApT}łltI҃SNSوRhQCTbLpTLPiK
fz	҅
fo	u
fb	󾈡][f]
fu	ۮܽݳ߻߼TnY_b`}mDcˋь@T}͐NʒBѓߓꖎ󗭗ӗژ_LޟJrcsMoitw}GQyOJcA[rJEn`bJiwŀƅCXQiȃɒʍ̒bk|͗luГЕ}ч҄ӇcDfؓxَ~PoݕݗߏߑGM~KUaRVhv\OTfHVvvDIWqfAF
ga	¿ŇQV܈mp
gl	øĸŸƸǸؤ_Y㓩|q[yiwDȑwԓdW^@}dB
gj	ɸʸ˸̸͸θϸиѸҸӸǬߦqx΂Q֏唐UogNl\qYCmCQHrlJCMs|D_vxhN
gh	ܸԸոָ׸ظٸڸ۸ܿ鄂Ոޑߒⓕ¯ILVGs
gk	ݸ޸߸غھ۬޻﯄ƅ̉RwJXlcoVǐ˛azp{k
ge	Ͽتܪ}Åφ񏐐͑뒚Rqz𠘠wvIZƌwx\kԆYgݑPtdkwxRkuZismwB
gq	o
gf	بݢށ^
gg	ب၃jyjԛʟubcK}c@sQif
gs	@jybmEr|˫abTkǂyؕp\Uq
gb	ڸ׃ڈx򊥓ktϟvYTUVaƙmНѐM_ԍmxُh^gxL
gu	¹ùĹŹƹǹȹɹʹ˹̹ͻڬlfg؉}~HMbO}JkWhYHMSBlÙƂu[vMbZLMݞEdkYA]
gd	ιϹйѹҹڴքFqOQ\GLƂ΁Oԟՠo|TNWm
gc	ԹչⅨsʹy
gp	׹عٹڹ۹ܹݹ޹߹ݸOjTgpHeA`oFҋQ^؞݄k]rvKPq^b}AJX
gt	ׁUZڏVљӞ՞֟DEqQSƚڇ_U
gm	Ȳw愣QT@iʔQ_˗Θuƙ͚w𜈜ĝgYInzuWKlvĄƗ}l͊ΚjO^ҎmԎdFFb܉ߞF|{WohkqZiW
gn	ح琨LeOiɀFЖ@r֏݁P
go	FJH͈剁I똡uX㯆l@[BNsǑbX{^uJR
ha	Ux
hl	㇯hoQw߀@V
hj	΂˄T{ci΋KI~cNț۝hߠRH]ybQtGk͔KLΑ֛EJt؁FIdw\\nnhuHUAAN[
hh	sVWfaRؘކߒ@
hk	ºúĺź޶ۃS_szhaؗB靻|mhD|Ar̖̗ϖՒqz
he	ǺȺɺʺ˺̺ͺκϺкѺҺӺԺպֺ׺ЫڭޅYۇmPuBΝZeCnFABEiKtvGMrΘϚЎ҇XZԆy؀RAFYuxHaefgHMgKQSiL[
hq	ٺڝ\
hf	ۺܺݺ䇌ԋ
hg	ߺ޿솑aMBtÆuUCa
hs	ڧݦޮްƅ˅ԆM߇kftcEEЕ{Kě͜|~pY{fsCto|yȇȈӏADFܟݓZvpUfb{\Z
hb	ܩˈT@FJDȉ_CjAf`\cJ
hu	ͺ«[jsIOFP~։؊|ďuHm_OUHXRZ~WXGWڭ@Cn`SeĊS~LSd̏̕Ιk֗omܠtLai_gbEU{sU]CKXI
hd	лFWNOÍ疁ɘ坱hAEBp_AIJyΔiԒjՠ֜fEkfX
hc	ثׁ݆Fđљƞxjx|ёќՖ
hp	»بۼߧ߆ȊJ֌A~`wёדQkhZgoȝמ🨠B~h]bQvKBPVːΌגho}؎S߀hDGIXafOdbJq
ht	ĻŻƻǻȻɻʻ˻̻ͻλϻлƆňENhrxUNs͖MRnRꟺpkCmŊȏYԅWeڇwBcbmUS
hm	һӻԻջֻ׻ػٻڻۻܻݻ޻߻ڶޥaRGjv߇H^ό@Ꮉ@hjo{}]֕ۘBmx󝌝`CFSZ_g`N~x_}DLEPU]C˙lsYz͠ΚЄы^ԐԜdMMefwYVxޒDiT_DuW}_HdtH
hn	ڻ[Gǐe򚉛kqdEJȝo՟FQaZ@
ho	ͻ޽߫i؇Ɋ_N뙊[Cm@\nEhGşu^fm؛oߘxZXo[d
ji	Ի¼üļżƼǼȼɼʼ˼̼ͽآؽ٥ڵܸުߴMU_΄WZޅhu\jIJjیcN׎^ꑢՓVēؓDO̖OmOۙCWovÚDgPTdE^usU^u]ISI]bem}Usuoo@M^YabcfÐlUŝƈƖgȗaDmEjRnz~aΎlυ_wHQ҈҉JfsӋӛHՂՑI^C}يl|ږEaepۈ۔Qu݋UBlrgWiHYu|}PVZ|KnyJaCDqKHWanAnTUVW
jd	μϼмѼҼӼԼռּ׼ؼټڼܼݼ޿٤ۣʁrk]AT_ˏSz~aϔЗkݘ\kxvѠǪmowO_`v͐Wj؆ZOPee]a{G
jw	߼kc؈ԉA{ԏɐ쒳BWs𕩖gʗߗc٘zҚל\puRhҟ栠\l{ORv{DMSa{]EWG}VO[ŞDGȂ`zʗ]ûMϕIMO}ҊSVdՉՐGֈtv]b`v{ڙ`_zJVsGIZab{~fgyK[dTeJCrxZpYx{|bj
jt	罩ǿׄ߅GDX\ڏx^@{{MT{PvwYK΅QHv֘nu\F
jz	½ýĽŽƽǽȽɽʽ˽̽ͽνϽнУٮܴߴރeӆUɋЋjۍBِxד蔇ҕwݘȜ]쟔Hd~CpRgUq_zĉTLƛˊ̗ftXӊԉK_]ڊ]^IqRfoRj
jx	۽ҽӽԽսֽ׽ؽٽڽ۽ܽݽ޽߽쿬ڦځN͂܃rfgomÆֈodmÌ􍛍ˎ^юȐTMtAHPmwÚϪEdpvC^XVMYefÝŋ}ǝɕ͎̈́͝fϘϝVw|ЍK\ћnӓԑ]mՋ֊ldeޗ]OYAeR^
jc	ݣ恵BHqBŅ͋⌃[|ܕxcVÝWaQn\nM\oNX]MǞBɓ|Pb֔فBMY\~^vT
jy	ݼS\qňgilncyǕߗJ}YGHܜQDsESZ`dptx~UÄGoȅȍςeVޟtRmnoKi@LX~
js	CTՃׇsQsӝKNQSSWѕޛ}yGo
jr	¾þľžƾǾȾɾʾ˾̾;݁LX`wBEYe{GHWA[`w͙͘㚔CTjmfi\BNbJFn
ju	۾ϾоѾҾӾԾվ־׾ؾپھ۾ܾݾ޾߾ڪgIehHaoωۊJՌe|lߏDI֒]ETHZxhΙۚjƛtHޟGhqʠYrM_D`KeŉgXaɛ^̘iAJЍznՇ؋kzڠBRgh۞Mv܇]ߚ`|LZuxMLX~VqGAe
jp	Ȧ۲̄ۈFIgԖK]ћ]CCvI\ÏCĖǚT^ZNmhjCJN
jm	ŽǾާ|]ZɆxH֌؍@D{ݒޔǙ@ܛQ}ؠuPikWNO^~_Ĕ`ʅDXpqМҏҙXӁEoH؏bkڑBjIf~Xp_`
jn	y͇h|TJFaBAqȚ^SDЂҟ܊xz}hKEzQU
ka	̈Ql
kl	ǄPцNK̎Ԑ@G͞ϞMa|bz_G]a
kj	Ƕ٩ݨ݈ɉd{ݙKM|Wb|ݍݝRR_
kh	ܿօH㋢܏oT^~z{ߒ_`K
kk	ϔ\_^ӈD}w
ke	¿ÿĿſƿǿȿɿʿ˿̿ͿwĄ˅\ъČQPِړUt}ʚΜfGܠɯzRh@LS~mŋdP_ЎnڐVfWwS
kq	w
kf	ϿпѿwG\yc~o]l
kg	ӿﬄcRs@nUVLHl
ks	տֿ׿ﳜwIy
kb	ٿڿۿޢߵ؃ㄛtDAr]glpf@d
ku	ݿ޿߿ʥܥVWH{\@LsfdFѝڏڜߠp
kd	٨Emv\ЎFg
kc	ۦڃ~SQKwXҪE[ĒiUd
kp	ŌpELUCwy
kt	ڲڿ܁ONjDbǑȒ[prpqmqVnT_kENLIܒAHߝkk\Y
km	ظ̈́lT]Ōhu|u晜CZzQAvCĄJʉwlẁ̝dۓikKq^N`rjY
kn	Ո҈܉׉ڋGyٝj^@HǍJTXhтc~KOH{Adq
ko	҇pUItNuvHATS
la	ēXYyjmrėDǉˈ`|ϞhnJBF_
ll	g|Іŋ@YƔjʜZ|[[]AXs[RDsvlهF[nmsQD`H
lj	܃Nۇ݈hGӑДGr̙ڙǞEAL]fsf@_ha|ȟ{km[hwҀE[E׎_Y|@eC
lh	ݹZɆ]i~ɖJTODR^ÞŅvɇ͙LqHOZ@
lk	XچK[Z`ƖUQНJAzjSgNox~Lu
le	߷ASWi{IbE
lq	ڳ񃱅C͔bÙIzNWXatwhn}Buˉqr{̅ϜC|[GDhYL[KmPF
lg	ܨ㶂}GJks
li	تٳٵ۪ݰ޼߿󃢃Ń^{o·щWȊڋKCVތbhq_cFi~ѕ^Жۖt~svӛlɛ˛kWrisӠثP|FO[LX@PZ[`Y]w]hHcFrfÚŃnƍVǗTWk˞yj́G΀[~ϋϠGYeџӀւׁN؂\V]^߆ߊBrWG\g_`xZcPfPkuw~EtvbZY
ld	z
lw	ぎIUVtYtՑXzٓaǝiԝȠRInS^d~IĘjɏOW_`΋ўcҜ֋`ۚBzb`Hn
lt	ܮˁIZɆ]|ȐśZHnÞ͙WoՏgv݈cyn@u
lz	ޤӅ׍ۍ\lŕxҠrvVtNkĂˀYioIْێG|Rfms
lx	|Æ`G_{蒞YMimڪdCF~ÇƔ}ޘVQhv
lc	zjCɍ[tԔݕɘ_ǝŞilUVrRS@LRHAUC\kO`lOCC[O
ly	۹삒c{ى犖HX`EЙRΞUOsg{n@czCʙheЇkfښCsqt_`I|CNo_wgh
lr	̄vg͏A˔ΗBPPfxgޫ]oq@e^S[]s˘Y^ۉyBsHwCdivstjVwm
lo	
ls	¡¢£¤Ū񪃥UŉƌabܒnoVYɜV{zab_o\\@ʔdFHitFLL[Xx]N_GT
lb	¥¦§¨©ª¶ÃErDv͍IfǜӮRkteŔVN֌}sUVt
lu	«¬­®¯°±²³´µ¶·¸¹º»¼½¾ޤߣԁJ΄ۇPnoVL]]m얛Ę̙ڜGOFZoѠtGSfofJRFtz{cUVrrFyś@AǊɝIʀJ́̔FBtӀTڀjۍ`A_XhjGeuzBJzIw|cnRuu
lp	ǁvyJKaD\n螤fgcÇLMH̉TF[
ln	ESӱK]b@ǒFՓi݆M
lo	ÃsӇލRӔm{因TΫMe`Jjjz_TIzɠ}xҘTZs߉biwB
lv	¿ڂHEiΆ`ҍ]fǗoѝUVflk~tGv|oy|Ȅ˃@֌}LXreHy
lv	ﲄG^Dsx
ma	ô؆OߘqԠЪwqKaTlMRhΛWjURKiN
ml	۽ݤτX}{h]Iu~@
mj	áܬK̐`Mϝ٪mzAp\UZ֙NzMN
mh	âãäåæçW܊}MnxKgZƟǃM{ϑI
mk	èéêëìíîïðñòóցiЃӃ؈uؑʚӜ~ӭpgFEdrɋcґ~؈QܚFT^W
me	ôûᇡQN
mq	õö÷øùúûüýþÿݮȃЈbrËZʍے{uϘM]iBCsctS|CozÊPƀBjnڛzdYV[imBeq
mf	BЕȘѠFjJ`ǖ̊{TY
mg	åޫ̑BMٜɝBHmZm_pM{iDWXQjLs
mi	ڢ߃QBsaȏۓC}aƙmP_}De󞅞ǠJ~[yz[HA]dȎoUZzAҒғҚԙikfSJ
mw	Da҅iҖu󠤲EdXP|xeϟrt|@IM
mz	èŁbRQkF]
mx	ؿ_Pϑ̓}晭fuI`Ҕfxp
mc	obǈBǑOϔFGbYzx]aRCIrFϟFh}sw
my	ڤDLҘiubqKԚpQ
mr	և
mo	ôûġĢģĤĥĦħĨĩĪīĬĭĮįİx\sۑ۔V}bz{]fjCtuah]cUQ]}g}ōeˏ͈_JփքO{؀|AxrNOa
mb	ıĲĳٰʄcyw\_wJE
mu	ģĲĴĵĶķĸĹĺĻļĽľĿLއ`Í\H]ҚҞѠ񪅮ryc}kōƟǀr][afJ
na	āpȆ{fg{SiМFiyvyہܘGc~
nl	ؾܵ͂i퓈ïGGΗєޕr
nj	O{ɋRړD~~lQay
nh	߭فeraTQ
nk	ثͅD߉닚pHjuFϫDLLZ×QXĞjuiDtm[
ne	ګڒfG
nq	ڃȊ̊ߚÕFMH
nf	\Q
ng	
ni	٣ÃЈӊNTɌېfvMN[zvuQfQāMsoe͉UzAryr؃Crދ\XWDFgu
nw	ճշإ`PדӔf^ݜVǟ[j|vňڙۅۜT݂RTDdj
nt	݋|
nz	ؘƛ\UљB
nx	Ǉyˇه܈[ZTԎIǜ[QHbfY}ǌYAAבWfbcORXEDm
nc	ᒌÀ
ny	šŢAތ|QFÝf_VXH
nr	ţŤťŦ椌MFS\Ƞ~yZo
ns	ŧŨũŪٯz`ם\JZvYē_ʝarsxP
nb	񆎓xAake
nu	ūŬŭՓxe@iw
np	ůfq`
nn	\Q
no	ŲųŴŵﻃsޑڒxj`D÷LzKXDEZہSG
nv	ŮH\sxS
nv	ŰűFo
oo	Ŷއp
ob	ŷŸŹźŻżŽخک^IpYWaTUpɒq֎qkt
pa	ǰžſr񝏰qutВڕZ
pl	ٽߗ۪Tu݇W
pj	㷬mcbΠPe~[TqgΌїjAۘoQGb
ph	󦅀狘ϛP`кUTpt}IIړQo
pk	凥E䠏ܭhP^ÇadЈьcNB
pq	_vCyh^ȗś֠高aSɄ[pr\k]s
pf	ԅ܆χ\MȆv
pg	ׯܡ󲂇XkyusZė՘՜AKmpԯnvyy@UegMLlesJ~݃JAmosuJi
pi	ٷơƢƣƤƥƦƧƨƩاۯܱߨɇGBWyFC[kݞ̟@iFGuyKfz`\YØMmknoΓK|uwWtYCVoRyBQadG
pd	ž
pw	ƪƫƬƭx̗FpAqҐ՗՛GXMwN]_j@
pz	ƮƯưƱݳG܏ґGܰXg~HEiրoQghw
px	ƲƳد뭁TŕҔv
pc	ƴƵƶƷƸ򭇹ЋnVWI|dOؚlAPD
py	ƹƺƻƼƽƾƿٷ҂RB΍Jk{qڟvrJjfyzqgELɑOg̓uZ݃ZZTG
po	۶͇MUیFg^ʟBt~kbXcewOkHFp
pb	곅ąVˊEghr
pu	WOp򖿘kMjrorbmn[ǎhLicEVfٟThL
qi	آؽܻݽޭ聅[~хuЇrΉ݊ÎhisW哠ŔƔ畒O֗Rݚ⛛DlşdXO^DP[HJ\wJoQgKLN_edĚpŠZWjsITV[BΉBτϓ}EvzәՃH[M|ږaܕܙހߌVHWZKMBTUGnotlu}R
qd	ǡǢăXgْuUslڞM
qw	ϿǣǤǥǦǧǨǩǪǫǬǭǮǯǰǱǲǳǴǵǶǷǸٻܷqx߃LXkTUqd`RҎԏaRbÓ˔opqepNkF\Kȟl|dGR`xPy`{ÍdOň@ȓ`gnˁOZSՍtl@ܝ݀wTjQUEDXZcBceavU`cqRSgZkeb
qt	ǹǺǻǼǽǾǿĄ߆܆󉂉ԌZ꓌֗{ٝ\͠]}o[HmuzŚ@NbmۄۖjIj
qz	ȸڽ@Sṡaώɓ]˚򯠱~x[RNǟw˖VKSڈډX^EFNb@DyA~XmNf|~
qx	ۧLܖAmCmGl`D]j~͉o@
qc	wa]܏Ra͓lܕTvNJpllQOǙǛBCZOψHW_c\sudzVVj
qy	ʤA͆xFc[N_|tȍHՈXpW[im
qs	ܺƃCo^đwKwzW`F\H|}˕͋^
qr	ҵٴܴHpwpn|@z_WrUGHkhEzFicɒUA͏~b@apӈӉgzڂޝbUMFGFpqAGjU
qu	ȡȢȣȤȥڰ۾ޡ޾ǁҁڄ`J^{oElߑt|יTaS^lyLcPJ^alJǆȁm΃JgRdРNUYsxoemzڅڠd|@ޑQrln@LOzYCDLzx
qp	ȦȧȨȩȪȫȬȭȮȯȰڹ܁焻񆭇IAZkwјTؙLŠlohJXCț̆SjԏwImbzBjEgej
qm	ȱȲȳȴȵȶȷȸۧ߫sUyUnPjF_`C]UX|Iao
qn	ȹȺ҉lnVtdZl
r	
rj	ȻȼȽȾ׃х߇YvLzVGctЀЅЙۜ
rh	ȿ𦃨Ӟ}KyZj׌`X
rk	Ɣ_n@ʁYvN
re	cxkہ
rf	ŁUPZkߖesexVBMH\YǌGӕJךrܐܜJmz~g
rg	Եiew
ri	ՇJ~_R
rs	Ԃc]ʎVmrјsx՞qVhZ\q^sƎ΍ϔђPgF
rb	Y`Qny~b\y|j݊qkk
ru	Ů޸ʆ䋇]CJdx^TdNSʇMߏr}pMn
rd	
rp	Â뉼\ə^}wMOXQpܛ݉
rm	ި򸅱Ǌ񐻒fMGIcqBƁtGHTJ
rn	ƲpČct
ro	ټ腪גcxkOme}U
sa	ئc_̃QlpS`
sl	ƃwTH˺ِ|w
sj	ɡɢց^xqɚНѼBRVW֍DodL
v	ɣɤɥʖјr
sk	ɦɧɨɩܣאߒלвRAAbX}f
se	ɪɫɬݑܚmoiiXiwN֠QlCm~o
sf	ɭؘI
sg	ɮO
va	ɯɰɱɲɳɴɵɶɷ肝x~ÎBEfךĪQ}ǝSe|
vl	ɫɸɹY\L
vj	ɺɻɼɽɾɿդڨ۷ރRh·AZEcҚ`SĪGU_È`πIv@Әbi٠]ܑߍWX^t~WX
vh	AÌv^Cg@yKDLxօpJll
vk	ۿԅpx{BKzpЌimY}
ve	ʲꅇLؒwΓzݛhh~JFͅχOdhfAsM
vq	l
vf	ʲڷݷׁLAqvzJY֕ܖY؝Bc|`e}mssprDKÌIȐɆQM͖[\BYԖՔ}ןߕhvTVY_
vg	ʡʢʣʤςم։ΕNӘ|T}Ɵ{]iIK}ƁoWKًHjj|
vi	ʦʧʨʩʪʫʬʭʮʯʰʱʲʳʴʵʶʷʸʹʺʻʼʽʾʿݪ߱Fdh~݅bڅFP]Ҍgjpƍ]֎sʏ^ɑJEgrɖNVtynҜ̝ۜHL{acixubEjJkȞNPgt|Ѡn|ҕlԇԊ՜՞uRBYyYm}ߟyPyAJvKzOS\ZX|O[P\a
vb	bۉޒ쪕FlRJ~
vu	ȨˡحٿJTCFَX擹dXИ]ѝ򞂟YqEPwROD[\˟̠OWgVel֑QHS\ܓݔg_fTx_nte
vd	ˢˣX
vc	ˤ˥˦˧i
vp	˨˩̘YV
vt	˪˫ˬׂuSܝw{dYC`pLZ{Ut
vm	˭ˮ˯˰ߊ܎ɚ絈ßcflj
vn	˱˲˳˴ݓMJipʊB
vo	˵˶˷˸d`FqTpfhlp
si	ʳ˹˺˻˼˽˾˿̨ٹݾӁˁ̂hƂЃ@zًwKPyƗ{q[fDLTriizQBʑʜ̌E·ΒazҖp|ޠLjFlJr\t~lfD
ss	ڡݿ񵂑؎ZmKsB볗t@Abm
sb	޴υCȓߔ\vPfLr˒jng}`tp
su	ՂуDՈTO呈VjɘŚߝTXdcBd@iChx˂KVVqxiop_MXTh
sp	⡅Wi{g
sm	ݴa̋Ӎ`bpqr˛ԜܞvխjBZX[uZÜĎV]Ț`r\wUwySmv[}l
sn	ݥЌOpqsSpʘV{Z
so	ɯȂŜRFwzWsjȚRіtۑC\ai[
ta	̡̢̣̤@쇖ŉd\ϛ͝ߝ꠭HHkNяwnQDceBJ]dFY[O]
tl	̧̨̥̦̩̪̫̬̭ۢ޷߾؃rULBE@̞M}xF_vǠU~T
tj	̴̵̶̷̸̮̯̰̱̲̳̹̺̻̼̽̾̿۰N@cdŉ򏗐ZoZҘWAUfacVgWjlIn˓gfՄTZ؍؝ٜ]avgUtZl
th	ڃRnɑܓy霫fgCUgKLCQgyTvZ}ۏTohM|EOWGUnyS
tk	ػ߶҄G|qdT_lIiӑ|zݝޏ[cNwuP
te	߯﫠Îfcؖ
tq	߯
tg	\bׯ\LTgĆ̄Ο`߂LvI
ti	هDXqόэʏӐɒW`GNYzvYfA_aGGHlʃSy{|pڄڌۇn܃ޅPXR}fewk{[Yef
tw	̆\cǊĐו`pLk\xt]V[kKgbqJC`qڙL`DjpcV
tz	٬؋iGfqI]lԵxIgrwxŗKVɂɊқA{q}pxf
tx	хGzuNF
ty	ͣͤͥͦͧ͢͡DKNǍ؎ߏadbHwsNPEkj[ ÉJbPFߋbcF
ts	ͨͩͪͫͬͭͮͯͰͱͲͳʹ١łLMdQqzӖSHԛϞןժI]rcpyZĀɌUVhԘUPn~j
tb	͵Ͷͷ͸ʈǊUӠ}e^WB^W
tu	͹ͺͻͼͽ;ͿܢݱlCDEMT_xčOLؓ\^yBޜfd\R]ǁȋ\gTރQWGBIWrhC
tp	˰F_`liaущ؇o
tm	˰ՂMQUьwL~vÕɗ˔L͑dׂۃ۝PjknDohs
tn	ֶ׆pdHNlĆęXPZܔ``
to	˰ر٢McsAɓlE͚kaPXFÓh[EІБЛӚqיڗ|܀~ސleuWXjnCDDzrK
wa	z܎Νj|DvemFߜcp|
wl	ˆx
wj	԰ܹݸ{\denGϊ񎦏e̕viȞTDwOUDÁ|XfHTؙٖ@lkn[js~B
wh	́ǌ[MR_]ZWwD^͇\syނގ
wq	Ρ΢ΣΤΥΦΧΨΩΪΫάέήίΰαβγδεζηθικλμνξοޱہ΃^y҇ËWnyˍ_eUΏڐi̐Α˓Gf͕|ۗܘLޛw՜❑HSwݠVҠc^|M_Lzu}SjoSJW^ĎYƄƑUǋȔȖJɖlDe˗fvOTVkoGloEAWԕՆ^~׈cZ^E`WMAGSflt|Q]]j[\]Kdnghz
wf	Ѕ݆ep^hjSXb؞ɟ\gyAIWÁÂ[|ʕPΝRюnݘݜdZMbmYjs
wg	޳؉RTǔwY\ΊfOlN
wo	ݫf_ӒܖusixYCOğPşn΁blN}
wu	أWWՅtǅ҆f]VÊӊՋ}ΏTv퐒GHNhJgT@A^rםoʫb@NWEyJIP|ƕ`ʏFΏwG_`OڏRA{NwEnouFFW}\M^F~cHI
xi	±ϡϢϣϤϥϦϧϨϩϪϫϬϭϮϯϰϱϲϳϴϵ϶ϷϸۧݾS`݄D[ckwAՇq։GfČʌڍƍQdЏOY_jMQVݓyʖyN̗~S@]SdX_myOx̠נުLNt_qmGOkYk]uGM{pZ[bb}Yjtʓ@̟E΀ΉkPau҂ҠB}ӂӄLl֐@GHgl؉TVivےhgߐESq@MR|bca^SK^IUeFOqwN]@^T_A
xd	ϹϺϻϼϽϾϿBb҇Y{BˑܓBٞMKPLWldE[r{SʛCrΘBYݠ_]ipPhyT
xw	ݲ޺ق]MgmnZmJhҊދM͋ݍsMҏ``y{ȓ͔gs}Z̙לǝnAINFQBG]hvUiS`LmQhoww{jd@O`x{Wˁ\p̀͘jDvҊP^tP֛]RtD`۟]܌ݍY_z}DvvefU`y@WuMrxyGE
xt	ܼρ߃↓Dݕ}ږ٘U֝E||vfčeGJφVԔKކ_lmx}}AJaP`z
xz	غŽСТУФХЦЧ̂Pj儿DCEV[^Ƈ̊n鏖k`ߔÕԗnϚRY^ߝx͞t^Veh~nqS}ąpʒ@Zṙ̍S]vDFԉ[qjyXUNIYfnu{^
xx	ШЩЪЫЬЭЮЯабвгдежзийклмѪҶޯߢĂăD愵flÆfGr@ȌьԍlOǐeayXy]fwʞaLcXynTcmcIXeuTi{|~nˆdqϐϒ~рCpiCxfאaCPRk@K^ak
xc	нопضܰݷ΁r|׌JߏQזAԟ{^UÒgWDM܌ߔd\cQ^
xy	ʡʤߩʁ邆QȊyۛwMmBdn͍qw_D]othHUS]
xs	ܺMrrKwԞכלقU
xr	ۂcL򫋬LPNCÃÑ^vƒɊΐфхPTVnq}xGM
xu	ڼޣŁTۄԅrćbuي玭VATBdv옏A[~TUsTLNSrWxPVAw{H]m{^[ɒʌv˅̐̓m͂dSӒS[Ԃ՚[~֞נ[`Pqzr
xp	ѡѢѣѤب煺IH銈l֏RːБғER]t×]Ce@BQtIKuv_UPkLAQk{RʞBT͕hύfО՝XXzK܎xCmMyXC~N
xm	ѥѦѧѨѩѪlɈyWNGVÔĖݛ͞yKNx}ŖƋHЏ{opGjmzYL`
xn	ѫѬѭѮѯѰѱѲѳѴѵѶѷѸۨݡަ޹ńׄ_Cex__ˊQeh՗Dߘꚦ[@`oFRpbrcĝȝMn`QryӍӖӜԃbޙdRZS\RZ
ya	ѹѺѻѼѽѾѿ]o|sBLRۉISގ~閑QcmeP{lEyʋҁӠ܈XEfs\
yl	B⍎
yj	ٲڥ۱۳mB]ym͇{ىc̉zԊ׋ǋ͋EߍirstvmݑÑZɓCRV󗦗ܙLW{vϟSeg̟wP_J[xNhcw{dEFGrTȊBW̚isъҍ_ӃӅԝVׅחVWٞIy܂VIDZz`aZmCKVYzFe|oHNe`}GdfijksBz
yh	ւꄽ؅tPĒtPaD[DӚTޚ睋Y柬WjS@Dfko^hUI݌Z{gR^rBuF
yk	ôҡҢңҤҥҦҧҨҩҪҫԿزسߺx熺ڈQaiACQqeuꕬ̗el|ȜƠdrlnGHOsfŗwș@|aˎiЉҝ@o{|׊Ub߈c_uP[^_rGo
ye	ҬҭҮүҰұҲҳҴҵҷҸҹҺק􁋂pSlIJw@IKLϕЕISc֟]{Luw|BE~J]vPXyEUdHvYv@BwEg
yi	̨̾βҺһҼҽҾҿ٫ڱܲܿ޲߽߮UV{ʁ́XÃx|σރքFj҈I`ˉ҉ߊf΋ڌTbh[FKMo@qŒ̔˕ٖpsؖח]j}]cnuśΜj۞˟y|֟۟DJW~p}CAmGeEtBhFjvImJOX[prx]kELjŒŜNiqUɚ˄ˇ[̈~͂͆ΒΕΜρtБК`vA]~~ӔTUmrԄx֖bghrׂה[\sؗOٌٓژDW}Tjv~ސޖޠzcty{NPzAiFOdcJU{kA`kGC^s@kop]pt~
yc	ҿӡط۴ܧ܃w􈊈AH|\J֑@\Ֆ@VaәP^ޜ@ZlKEaHNstgZM_aaPrPӗӝCzN׍_ylDSYiwyfL[Sgl
yy	ӢӣӤӥӦӧӨөӪӫӬӭӮӯӰӱӲӳ۫ݺ󿂟OӇ|Lk[ʎcg_ᑪlt@P@wљ՛Ɯ}L]uɠIEOZ`jAQ_fYkxMtm{tpcws΄ΞωNњLhGsaA܅}v]AeIjDLKW
yo	Ӵࡆч
ys	ӵӶӷӸӹӺӻӼӽӾӿٸܭӂʆއMӏb[~Ӑ햺ԘKўMblHoԁxa{kVOtJIx
yb	̾٧ݬݯݵJۂNemMfrMQnɓAX`AԚSY|HXqDhvxnlghyiuUÅhx~͜ITzjݒޔޜK[]RBfO~
yu	¹ȿεξԡԢԣԤԥԦخعٶsRqhʅPɇoSֈʊӊ؋V䌆Z󐃐jGT˔єf@KșQeu̚ќMUOĝ˞~z]_Z^rmKEI_HNRrCU{zhBZnusN|cńņRƑƜghfəvʚʠP]GC΃LjsшDZ՘I~u؅؋u܆hݛX}NyߎhCqD`[~|TkMAYN|Se^kcdr~ViN\O}COr{
yp	ԧԨԩԪԫԬԭԮԯ԰ԱԲԳԴԵԶԷԸԹԺܫܾӃ҄uT@A튀wzgrYaemƞ]jkx\F~OƊAVdQW͛QmzcjrцѓwؒOk@Rh߇ߖJr{SxtMgx
ym	ԻԼԽԾdx[xF`ՕS]~hj^MCalsğgQRڌڔS܋_XNVg
yn	۩ܿށք򆽇@[uCdlXvVݝ«jsdpnoJAZamZ\CQl|ʕʟ˜NQ΂юلٚS\iydjq]mEBryfwNay
za	զƆm͇ԇَYeHNSށNjs{
zl	ށDĞPfنdP
zj	ɂ̃kԌv˔eVjUg`d{{דmٝڎAYZa
a	갅MZnnĠKN_jENQzGv
zk	rVҗ_boY^rŁk֍Yڋۛs
ze	զtKْkWgzڝɞcjdRmyjϏ]Ջ։؟ّfB
zq	ό\fe
zf	ړPU
zg	קּ׉IQDC֟ٛ{_
aa	աբգդեզէըթ߸~͊LosŘϜѝhdzPˠlupՋ֊AQzۂ܈mlCW~O
al	Լժիլխծկ񩁅Ȃz~nƓȘzyySS
aj	հձղճմյնոչպջռսվտ칁ׂ~E𒀔ؔC֗^֚جWKD`ǕƯ̜җOa`dזjۅۊuݚJ߁\@nQse}g@ZDrr
ah	۵@zǏ{PEqodÛɟ~lbL\J
ak	צگɁԆזݠYD@S|^ADǟtwWDqeJh{
ae	رߡ^uzbeVlΚyJKYqzEUVПxԀֆ֑֕yׄmtH@ONXp
af	Eɉ`zǎbrL_זڗFE^皋تpwUGtEGbjrZȜRm͖А]\gnؑcFݟtZGI\@gPk}Iaycl^m
ag	֢֣֤֡ں݁̈́J^oяՐ~c@ՕƞڟAbYk~Pltw^ՊCt`P@Sg
ai	ְֱֲֳִֵֶַָֹֺֻּֽ֥֦֧֪֭֮֨֩֫֬֯־ֿشۤvfuЃM}^p̉y~͋ÎDÐ]depƒWnwST`ՔyydЗulDEbF]Z\ܪOaM}FOUWUYowhoq~Wae@{peqĈ\]WƏǠˌuHd}ЁЗИuxjҞdzJIRTUؠ|ٗږNېەUW܁TeތgKke@nb\csSTvAEv~
as	ڣZdVXqtgזHpOwƟ~rNWbK[ƠW\uΠ\x{~A۠{VR
ab	ݧƁuمBBŐJ@LJTHBNQqUiFȒgkapמkQScqbLX{tLEB@b
au	Ţסעףפؼ٪ۥЄڈ|ԌFeٍXǘ֙{z۟GTvdpmhBZ|AZCqrAdɍ\ˠwώEWN]}DTiAڟHOގILT[vf^E}
ad	ץצtĐ
ac	קJ
ap	רשת׫׬׭QʈtNwAUsu|eiMxZRxEmNKNٍܞDH
at	׮ׯװױײ׳״ʉщՊyϑߗ[r`PPfb
am	׵׶׷׸׹׺ܖdIqYPJiՅm٘VWFMYVUKx
an	׻׼S͌dʶMqRՁބ
ao	׽׾׿پߪQV~ߏ𔽔ٔڔ۔ޕzផOKkqBWSmMv|ϗX}Վ֑}nr@C|
zi	֨ځk膝ꊜIUXjhUdnРRu{IfT|lzchuTƆƓƝSǏȌɛFI`JDYڃwݖtBOStCop\Ub
zs	Ղ~ُĐȐߒ֓KifQޝП٪`fSOF_ChtGkvCŋȠ~xqrۙSEQRiWAiR`
zb	۸틃tjǈՌ[Yu|EOPw
zu	߁ǂaX۠~BM\{a{֊ۀJ@c
zp	߬򄮓SgFjyٍgj
zm	ީT蘗diޝrBSx`fEPU@
zn	ߤVgݍĿIJV
zo	Fۗ}sidzgyzɁЊՋ